//MAP CONVERTED BY dmm2tgm.py THIS HEADER COMMENT PREVENTS RECONVERSION, DO NOT REMOVE
"b" = (
/turf/open/floor/mineral/plastitanium,
/area/shuttle/labor)
"c" = (
/obj/effect/turf_decal/stripes/line,
/obj/effect/mapping_helpers/airlock/access/all/security/brig,
/obj/machinery/door/airlock/titanium{
	name = "Labor Shuttle Airlock"
	},
/turf/open/floor/mineral/plastitanium,
/area/shuttle/labor)
"e" = (
/obj/effect/turf_decal/stripes/line,
/obj/machinery/power/shuttle_engine/propulsion,
/turf/open/floor/plating/airless,
/area/shuttle/labor)
"i" = (
/turf/closed/wall/mineral/plastitanium,
/area/shuttle/labor)
"m" = (
/obj/machinery/light,
/turf/open/floor/pod/dark,
/area/shuttle/labor)
"p" = (
/obj/effect/turf_decal/stripes/line{
	dir = 1
	},
/obj/structure/chair/comfy/shuttle{
	dir = 8
	},
/turf/open/floor/mineral/plastitanium/red,
/area/shuttle/labor)
"u" = (
/obj/structure/window/reinforced,
/obj/effect/turf_decal/stripes/line,
/obj/machinery/light/small/directional/west,
/obj/structure/reagent_dispensers/wall/peppertank/directional/west,
/turf/open/floor/mineral/plastitanium,
/area/shuttle/labor)
"w" = (
/obj/effect/turf_decal/stripes/full,
/obj/machinery/light/small/directional/east,
/obj/machinery/mineral/stacking_machine/laborstacker{
	input_dir = 2;
	output_dir = 1
	},
/turf/open/floor/mineral/plastitanium,
/area/shuttle/labor)
"x" = (
/obj/effect/decal/cleanable/dirt,
/obj/effect/turf_decal/bot,
/obj/structure/chair/comfy/shuttle{
	dir = 4
	},
/obj/machinery/flasher/directional/west{
	id = "gulagshuttleflasher"
	},
/turf/open/floor/mineral/plastitanium,
/area/shuttle/labor)
"y" = (
/obj/effect/turf_decal/bot,
/obj/structure/chair/comfy/shuttle{
	dir = 8
	},
/turf/open/floor/mineral/plastitanium,
/area/shuttle/labor)
"A" = (
/obj/effect/spawner/structure/window/hollow/survival_pod/directional{
	dir = 8
	},
/turf/open/floor/plating,
/area/shuttle/labor)
"B" = (
/obj/effect/spawner/structure/window/hollow/survival_pod/directional,
/turf/open/floor/plating/airless,
/area/shuttle/labor)
"C" = (
/obj/effect/turf_decal/delivery,
/turf/open/floor/mineral/plastitanium,
/area/shuttle/labor)
"D" = (
/obj/effect/turf_decal/stripes/line{
	dir = 8
	},
/obj/effect/turf_decal/stripes/line{
	dir = 4
	},
/obj/structure/fans/tiny,
/obj/machinery/door/airlock/external{
	name = "Mining Shuttle External Airlock";
	req_access_txt = "2"
	},
/obj/effect/mapping_helpers/airlock/access/all/security/brig,
/turf/open/floor/pod/dark,
/area/shuttle/labor)
"E" = (
/obj/effect/turf_decal/caution/stand_clear{
	dir = 8
	},
/turf/open/floor/pod/dark,
/area/shuttle/labor)
"G" = (
/obj/effect/turf_decal/stripes/line{
	dir = 8
	},
/obj/effect/turf_decal/stripes/line{
	dir = 4
	},
/obj/structure/fans/tiny,
/obj/docking_port/mobile{
	dir = 8;
	dwidth = 2;
	height = 5;
	name = "labor camp shuttle";
	port_direction = 4;
	width = 10;
	shuttle_id = "laborcamp"
	},
/obj/machinery/door/airlock/external{
	name = "Mining Shuttle External Airlock"
	},
/obj/effect/mapping_helpers/airlock/access/all/security/brig,
/turf/open/floor/pod/dark,
/area/shuttle/labor)
"I" = (
/obj/item/clothing/suit/hazardvest{
	desc = "A high-visibility lifejacket complete with whistle and slot for oxygen tanks.";
	name = "emergency lifejacket"
	},
/obj/item/clothing/suit/hazardvest{
	desc = "A high-visibility lifejacket complete with whistle and slot for oxygen tanks.";
	name = "emergency lifejacket"
	},
/obj/item/clothing/suit/hazardvest{
	desc = "A high-visibility lifejacket complete with whistle and slot for oxygen tanks.";
	name = "emergency lifejacket"
	},
/obj/item/clothing/suit/hazardvest{
	desc = "A high-visibility lifejacket complete with whistle and slot for oxygen tanks.";
	name = "emergency lifejacket"
	},
/obj/item/clothing/suit/hazardvest{
	desc = "A high-visibility lifejacket complete with whistle and slot for oxygen tanks.";
	name = "emergency lifejacket"
	},
/obj/item/tank/internals/emergency_oxygen{
	pixel_x = 3
	},
/obj/item/tank/internals/emergency_oxygen{
	pixel_x = 3
	},
/obj/item/tank/internals/emergency_oxygen{
	pixel_x = 3
	},
/obj/item/tank/internals/emergency_oxygen{
	pixel_x = 3
	},
/obj/item/tank/internals/emergency_oxygen{
	pixel_x = 3
	},
/obj/item/clothing/mask/breath{
	pixel_x = -3;
	pixel_y = -3
	},
/obj/item/clothing/mask/breath{
	pixel_x = -3;
	pixel_y = -3
	},
/obj/item/clothing/mask/breath{
	pixel_x = -3;
	pixel_y = -3
	},
/obj/item/clothing/mask/breath{
	pixel_x = -3;
	pixel_y = -3
	},
/obj/item/clothing/mask/breath{
	pixel_x = -3;
	pixel_y = -3
	},
/obj/item/clothing/head/utility/hardhat/orange{
	name = "protective hat";
	pixel_y = 9
	},
/obj/item/clothing/head/utility/hardhat/orange{
	name = "protective hat";
	pixel_y = 9
	},
/obj/item/clothing/head/utility/hardhat/orange{
	name = "protective hat";
	pixel_y = 9
	},
/obj/item/clothing/head/utility/hardhat/orange{
	name = "protective hat";
	pixel_y = 9
	},
/obj/item/clothing/head/utility/hardhat/orange{
	name = "protective hat";
	pixel_y = 9
	},
/obj/structure/closet/crate/internals,
/obj/effect/decal/cleanable/dirt,
/obj/effect/turf_decal/delivery,
/turf/open/floor/mineral/plastitanium,
/area/shuttle/labor)
"K" = (
/obj/effect/turf_decal/stripes/line{
	dir = 1
	},
/obj/machinery/button/flasher{
	id = "gulagshuttleflasher";
	name = "Flash Control";
	pixel_x = 26;
	req_access_txt = "1"
	},
/obj/machinery/recharger{
	pixel_y = 4
	},
/obj/structure/table/reinforced,
/obj/item/restraints/handcuffs,
/turf/open/floor/mineral/plastitanium/red,
/area/shuttle/labor)
"N" = (
/turf/open/floor/pod/dark,
/area/shuttle/labor)
"O" = (
/obj/effect/turf_decal/bot,
/obj/structure/chair/comfy/shuttle{
	dir = 8
	},
/obj/machinery/mineral/labor_claim_console{
	pixel_x = 30
	},
/turf/open/floor/mineral/plastitanium,
/area/shuttle/labor)
"R" = (
/obj/effect/turf_decal/stripes/line{
	dir = 1
	},
/obj/machinery/mineral/stacking_unit_console{
	pixel_x = -30;
	pixel_y = -4
	},
/obj/machinery/computer/shuttle/labor{
	dir = 4
	},
/turf/open/floor/mineral/plastitanium/red,
/area/shuttle/labor)
"T" = (
/obj/effect/spawner/structure/window/hollow/survival_pod/directional{
	dir = 4
	},
/turf/open/floor/plating,
/area/shuttle/labor)
"U" = (
/turf/closed/wall/mineral/titanium/survival/nodiagonal,
/area/shuttle/labor)
"V" = (
/obj/effect/spawner/structure/window/hollow/survival_pod/directional{
	dir = 1
	},
/turf/open/floor/plating,
/area/shuttle/labor)
"W" = (
/obj/effect/decal/cleanable/dirt,
/obj/effect/turf_decal/bot,
/obj/structure/chair/comfy/shuttle{
	dir = 4
	},
/turf/open/floor/mineral/plastitanium,
/area/shuttle/labor)
"X" = (
/obj/effect/turf_decal/bot,
/obj/effect/decal/cleanable/dirt,
/obj/structure/chair/comfy/shuttle{
	dir = 4
	},
/turf/open/floor/mineral/plastitanium,
/area/shuttle/labor)
"Z" = (
/turf/closed/wall/mineral/titanium/survival,
/area/shuttle/labor)

(1,1,1) = {"
Z
Z
A
Z
A
U
A
Z
U
i
"}
(2,1,1) = {"
V
R
b
u
W
x
X
I
B
e
"}
(3,1,1) = {"
V
p
b
c
N
N
N
m
U
e
"}
(4,1,1) = {"
V
K
C
w
y
O
y
E
B
e
"}
(5,1,1) = {"
Z
Z
D
Z
T
U
T
G
U
i
"}
