//MAP CONVERTED BY dmm2tgm.py THIS HEADER COMMENT PREVENTS RECONVERSION, DO NOT REMOVE
"a" = (
/turf/closed/wall/mineral/plastitanium,
/area/shuttle/mining)
"c" = (
/obj/effect/turf_decal/stripes/line{
	dir = 8
	},
/obj/effect/turf_decal/bot_white,
/obj/machinery/light/small{
	dir = 8
	},
/obj/item/radio/intercom/directional/west,
/obj/structure/chair/comfy/shuttle{
	dir = 1
	},
/turf/open/floor/pod/dark,
/area/shuttle/mining)
"g" = (
/obj/effect/spawner/structure/window/hollow/survival_pod/directional{
	dir = 4
	},
/turf/open/floor/plating,
/area/shuttle/mining)
"h" = (
/obj/effect/turf_decal/tile/neutral/half/contrasted{
	dir = 8
	},
/obj/structure/chair/comfy/shuttle{
	dir = 1
	},
/turf/open/floor/pod/dark,
/area/shuttle/mining)
"l" = (
/obj/effect/turf_decal/stripes/line{
	dir = 4
	},
/obj/effect/turf_decal/bot_white,
/obj/machinery/light/small{
	dir = 4
	},
/obj/structure/chair/comfy/shuttle{
	dir = 1
	},
/turf/open/floor/pod/dark,
/area/shuttle/mining)
"m" = (
/obj/structure/ore_box,
/obj/effect/turf_decal/delivery,
/obj/effect/turf_decal/stripes/line{
	dir = 6
	},
/turf/open/floor/pod/dark,
/area/shuttle/mining)
"n" = (
/obj/effect/turf_decal/stripes/line{
	dir = 8
	},
/obj/effect/turf_decal/stripes/line{
	dir = 4
	},
/obj/effect/mapping_helpers/airlock/cyclelink_helper{
	dir = 4
	},
/obj/structure/fans/tiny,
/obj/machinery/door/airlock/external{
	name = "Mining Shuttle External Airlock"
	},
/turf/open/floor/pod/light,
/area/shuttle/mining)
"q" = (
/obj/effect/turf_decal/stripes/full,
/obj/effect/spawner/structure/window/hollow/survival_pod/directional,
/turf/open/floor/plating/airless,
/area/shuttle/mining)
"r" = (
/obj/effect/turf_decal/stripes/line{
	dir = 4
	},
/turf/open/floor/pod/dark,
/area/shuttle/mining)
"t" = (
/obj/effect/spawner/structure/window/hollow/survival_pod/directional{
	dir = 8
	},
/turf/open/floor/plating,
/area/shuttle/mining)
"v" = (
/obj/effect/turf_decal/box/white/corners,
/obj/effect/turf_decal/box/white/corners{
	dir = 8
	},
/obj/effect/turf_decal/box/white/corners{
	dir = 4
	},
/obj/effect/turf_decal/box/white/corners{
	dir = 1
	},
/turf/open/floor/pod/dark,
/area/shuttle/mining)
"w" = (
/obj/effect/turf_decal/stripes/line{
	dir = 8
	},
/turf/open/floor/pod/dark,
/area/shuttle/mining)
"y" = (
/obj/item/clothing/suit/hazardvest{
	desc = "A high-visibility lifejacket complete with whistle and slot for oxygen tanks.";
	name = "emergency lifejacket"
	},
/obj/item/clothing/suit/hazardvest{
	desc = "A high-visibility lifejacket complete with whistle and slot for oxygen tanks.";
	name = "emergency lifejacket"
	},
/obj/item/clothing/suit/hazardvest{
	desc = "A high-visibility lifejacket complete with whistle and slot for oxygen tanks.";
	name = "emergency lifejacket"
	},
/obj/item/clothing/suit/hazardvest{
	desc = "A high-visibility lifejacket complete with whistle and slot for oxygen tanks.";
	name = "emergency lifejacket"
	},
/obj/item/clothing/suit/hazardvest{
	desc = "A high-visibility lifejacket complete with whistle and slot for oxygen tanks.";
	name = "emergency lifejacket"
	},
/obj/item/tank/internals/emergency_oxygen{
	pixel_x = 3
	},
/obj/item/tank/internals/emergency_oxygen{
	pixel_x = 3
	},
/obj/item/tank/internals/emergency_oxygen{
	pixel_x = 3
	},
/obj/item/tank/internals/emergency_oxygen{
	pixel_x = 3
	},
/obj/item/tank/internals/emergency_oxygen{
	pixel_x = 3
	},
/obj/item/clothing/mask/breath{
	pixel_x = -3;
	pixel_y = -3
	},
/obj/item/clothing/mask/breath{
	pixel_x = -3;
	pixel_y = -3
	},
/obj/item/clothing/mask/breath{
	pixel_x = -3;
	pixel_y = -3
	},
/obj/item/clothing/mask/breath{
	pixel_x = -3;
	pixel_y = -3
	},
/obj/item/clothing/mask/breath{
	pixel_x = -3;
	pixel_y = -3
	},
/obj/item/clothing/head/utility/hardhat/orange{
	name = "protective hat";
	pixel_y = 9
	},
/obj/item/clothing/head/utility/hardhat/orange{
	name = "protective hat";
	pixel_y = 9
	},
/obj/item/clothing/head/utility/hardhat/orange{
	name = "protective hat";
	pixel_y = 9
	},
/obj/item/clothing/head/utility/hardhat/orange{
	name = "protective hat";
	pixel_y = 9
	},
/obj/item/clothing/head/utility/hardhat/orange{
	name = "protective hat";
	pixel_y = 9
	},
/obj/structure/closet/crate/internals,
/obj/item/pickaxe/emergency,
/obj/item/pickaxe/emergency,
/obj/effect/turf_decal/delivery,
/obj/effect/turf_decal/stripes/line{
	dir = 10
	},
/turf/open/floor/pod/dark,
/area/shuttle/mining)
"z" = (
/obj/effect/turf_decal/stripes/line,
/obj/machinery/power/shuttle_engine/propulsion,
/turf/open/floor/plating/airless,
/area/shuttle/mining)
"A" = (
/obj/effect/turf_decal/stripes/box,
/obj/effect/turf_decal/stripes/white/box,
/obj/machinery/computer/shuttle/mining,
/turf/open/floor/pod/dark,
/area/shuttle/mining)
"B" = (
/obj/effect/turf_decal/stripes/line{
	dir = 9
	},
/obj/structure/table/reinforced,
/obj/item/storage/medkit/regular,
/turf/open/floor/pod/dark,
/area/shuttle/mining)
"I" = (
/turf/closed/wall/mineral/titanium/survival/nodiagonal,
/area/shuttle/mining)
"K" = (
/obj/effect/turf_decal/stripes/line{
	dir = 5
	},
/obj/structure/table/reinforced,
/obj/item/storage/toolbox/emergency,
/turf/open/floor/pod/dark,
/area/shuttle/mining)
"N" = (
/obj/effect/turf_decal/stripes/line,
/obj/effect/turf_decal/tile/neutral/half/contrasted{
	dir = 4
	},
/obj/structure/bed,
/obj/item/bedsheet/brown,
/turf/open/floor/pod/dark,
/area/shuttle/mining)
"P" = (
/obj/effect/turf_decal/stripes/line{
	dir = 8
	},
/obj/effect/turf_decal/stripes/line{
	dir = 4
	},
/obj/effect/mapping_helpers/airlock/cyclelink_helper{
	dir = 8
	},
/obj/structure/fans/tiny,
/obj/docking_port/mobile{
	dir = 8;
	dwidth = 3;
	height = 5;
	name = "mining shuttle";
	port_direction = 4;
	width = 7;
	shuttle_id = "mining"
	},
/obj/machinery/door/airlock/external{
	name = "Mining Shuttle External Airlock"
	},
/turf/open/floor/pod/light,
/area/shuttle/mining)
"U" = (
/turf/closed/wall/mineral/titanium/survival,
/area/shuttle/mining)
"V" = (
/obj/effect/spawner/structure/window/hollow/survival_pod/directional{
	dir = 1
	},
/turf/open/floor/plating,
/area/shuttle/mining)

(1,1,1) = {"
U
t
U
n
t
I
a
"}
(2,1,1) = {"
V
B
c
w
y
I
z
"}
(3,1,1) = {"
V
A
h
v
N
q
z
"}
(4,1,1) = {"
V
K
l
r
m
I
z
"}
(5,1,1) = {"
U
g
U
P
g
I
a
"}
