"aJ" = (/obj/structure/closet/wardrobe/black,/turf/open/floor/mineral/titanium/blue,/area/shuttle/arrival)
"cK" = (/obj/machinery/vending/tool,/turf/open/floor/mineral/titanium,/area/shuttle/arrival)
"cO" = (/obj/structure/closet/wardrobe/green,/turf/open/floor/mineral/titanium,/area/shuttle/arrival)
"dx" = (/obj/machinery/vending/drugs,/turf/open/floor/mineral/titanium,/area/shuttle/arrival)
"ei" = (/obj/machinery/vending/snack/random,/turf/open/floor/mineral/titanium/blue,/area/shuttle/arrival)
"eS" = (/obj/structure/window/reinforced/spawner/directional/west,/obj/machinery/power/shuttle_engine/heater{dir = 4},/obj/docking_port/mobile/arrivals{name = "dorf arrivals shuttle"},/obj/machinery/power/shuttle_engine/propulsion/burst/right{dir = 4},/turf/open/floor/plating/airless,/area/shuttle/arrival)
"fx" = (/obj/machinery/light/directional/north,/turf/closed/wall/mineral/titanium,/area/shuttle/arrival)
"fB" = (/obj/machinery/door/airlock/titanium{name = "Arrivals Shuttle Airlock"},/turf/open/floor/mineral/titanium/blue,/area/shuttle/arrival)
"hS" = (/obj/structure/chair/comfy/shuttle{dir = 4},/turf/open/floor/mineral/titanium,/area/shuttle/arrival)
"iW" = (/obj/machinery/vending/coffee,/turf/open/floor/mineral/titanium/blue,/area/shuttle/arrival)
"jm" = (/obj/structure/table,/obj/item/stack/sheet/mineral/plasma/fifty,/obj/item/stack/sheet/mineral/plasma/fifty,/obj/item/stack/sheet/mineral/plasma/fifty,/obj/item/stack/sheet/mineral/plasma/fifty,/obj/item/stack/sheet/mineral/plasma/fifty,/turf/open/floor/mineral/titanium/blue,/area/shuttle/arrival)
"jC" = (/obj/machinery/vending/wallmed,/turf/closed/wall/mineral/titanium,/area/shuttle/arrival)
"kr" = (/obj/machinery/vending/tool,/turf/open/floor/mineral/titanium/blue,/area/shuttle/arrival)
"ku" = (/obj/structure/table,/obj/effect/spawner/random/entertainment/toy,/obj/item/radio/intercom/directional/south,/turf/open/floor/mineral/titanium/blue,/area/shuttle/arrival)
"lj" = (/turf/closed/wall/mineral/titanium,/area/shuttle/arrival)
"lI" = (/obj/machinery/vending/wallgene,/turf/closed/wall/mineral/titanium,/area/shuttle/arrival)
"lW" = (/obj/machinery/vending/cola/random,/turf/open/floor/mineral/titanium,/area/shuttle/arrival)
"me" = (/obj/structure/table,/obj/item/storage/belt/utility,/obj/item/storage/belt/utility,/obj/item/storage/toolbox/mechanical{pixel_x = -2; pixel_y = -1},/obj/item/storage/toolbox/mechanical{pixel_x = -2; pixel_y = -1},/obj/machinery/light/directional/north,/turf/open/floor/mineral/titanium,/area/shuttle/arrival)
"nK" = (/obj/structure/chair/comfy/shuttle{dir = 4},/turf/open/floor/mineral/titanium/blue,/area/shuttle/arrival)
"oi" = (/obj/structure/closet/wardrobe/grey,/turf/open/floor/mineral/titanium,/area/shuttle/arrival)
"oo" = (/turf/open/floor/mineral/titanium/blue,/area/shuttle/arrival)
"qL" = (/obj/structure/window/reinforced/spawner/directional/west,/obj/machinery/power/shuttle_engine/heater{dir = 4},/obj/machinery/power/shuttle_engine/propulsion/burst/right{dir = 4},/turf/closed/wall/mineral/titanium,/area/shuttle/arrival)
"ro" = (/obj/item/storage/medkit/surgery,/obj/item/storage/medkit/surgery,/obj/structure/table,/turf/open/floor/mineral/titanium/blue,/area/shuttle/arrival)
"ss" = (/obj/structure/table,/obj/item/stack/sheet/mineral/wood/fifty,/obj/item/stack/sheet/mineral/wood/fifty,/obj/item/stack/sheet/mineral/wood/fifty,/obj/item/stack/sheet/mineral/wood/fifty,/obj/item/stack/sheet/mineral/wood/fifty,/turf/open/floor/mineral/titanium/blue,/area/shuttle/arrival)
"sJ" = (/obj/structure/table,/obj/item/stack/sheet/mineral/gold/fifty,/turf/open/floor/mineral/titanium/blue,/area/shuttle/arrival)
"wc" = (/obj/machinery/vending/games,/turf/open/floor/mineral/titanium/blue,/area/shuttle/arrival)
"we" = (/obj/structure/window/reinforced/spawner/directional/west,/obj/machinery/power/shuttle_engine/heater{dir = 4},/obj/machinery/power/shuttle_engine/propulsion/burst/right{dir = 4},/turf/open/floor/plating/airless,/area/shuttle/arrival)
"wu" = (/obj/item/storage/medkit/regular,/obj/item/storage/medkit/regular,/obj/item/storage/medkit/regular,/obj/structure/table,/turf/open/floor/mineral/titanium/blue,/area/shuttle/arrival)
"xf" = (/obj/effect/spawner/random/entertainment/arcade,/obj/item/radio/intercom/directional/north,/turf/open/floor/mineral/titanium/blue,/area/shuttle/arrival)
"xW" = (/obj/structure/table,/obj/item/stack/sheet/mineral/silver/fifty,/turf/open/floor/mineral/titanium/blue,/area/shuttle/arrival)
"AV" = (/obj/structure/chair/comfy/shuttle{dir = 4},/obj/machinery/light/directional/west,/turf/open/floor/mineral/titanium,/area/shuttle/arrival)
"Bb" = (/obj/machinery/vending/sustenance,/turf/open/floor/mineral/titanium,/area/shuttle/arrival)
"Br" = (/obj/machinery/vending/autodrobe,/obj/machinery/light/directional/south,/turf/open/floor/mineral/titanium/blue,/area/shuttle/arrival)
"BN" = (/obj/machinery/vending/donksofttoyvendor,/turf/open/floor/mineral/titanium,/area/shuttle/arrival)
"Dt" = (/obj/structure/closet/wardrobe/mixed,/turf/open/floor/mineral/titanium/blue,/area/shuttle/arrival)
"DV" = (/obj/item/storage/medkit/brute,/obj/item/storage/medkit/fire,/obj/item/storage/medkit/o2,/obj/item/storage/medkit/toxin,/obj/structure/table,/turf/open/floor/mineral/titanium,/area/shuttle/arrival)
"EQ" = (/obj/machinery/vending/clothing,/turf/open/floor/mineral/titanium/blue,/area/shuttle/arrival)
"Fv" = (/obj/machinery/vending/cigarette,/turf/open/floor/mineral/titanium/blue,/area/shuttle/arrival)
"HW" = (/turf/open/floor/mineral/titanium,/area/shuttle/arrival)
"IO" = (/obj/structure/table,/obj/item/vending_refill/assist,/obj/item/vending_refill/autodrobe,/obj/item/vending_refill/cigarette,/obj/item/vending_refill/clothing,/obj/item/vending_refill/coffee,/obj/item/vending_refill/cola,/obj/item/vending_refill/donksoft,/obj/item/vending_refill/drugs,/obj/item/vending_refill/games,/obj/item/vending_refill/medical,/obj/item/vending_refill/modularpc,/obj/item/vending_refill/snack,/obj/item/vending_refill/sustenance,/obj/item/vending_refill/wallhypo,/obj/item/vending_refill/wallmed,/obj/item/vending_refill/youtool,/obj/machinery/requests_console/directional/north{department = "Arrival shuttle"; name = "Arrival Shuttle Requests Console"},/obj/machinery/light/directional/north,/turf/open/floor/mineral/titanium,/area/shuttle/arrival)
"LT" = (/obj/machinery/vending/wallhypo,/turf/closed/wall/mineral/titanium,/area/shuttle/arrival)
"Pu" = (/obj/structure/table,/obj/item/stack/sheet/iron/fifty,/obj/item/stack/sheet/iron/fifty,/obj/item/stack/sheet/iron/fifty,/obj/item/stack/sheet/iron/fifty,/obj/item/stack/sheet/iron/fifty,/turf/open/floor/mineral/titanium/blue,/area/shuttle/arrival)
"PL" = (/obj/structure/table,/obj/item/circuitboard/machine/techfab/department/cargo,/obj/item/circuitboard/machine/techfab/department/engineering,/obj/item/circuitboard/machine/techfab/department/medical,/obj/item/circuitboard/machine/techfab/department/science,/obj/item/circuitboard/machine/techfab/department/security,/obj/item/circuitboard/machine/techfab/department/service,/obj/machinery/light/directional/north,/turf/open/floor/mineral/titanium,/area/shuttle/arrival)
"PY" = (/obj/machinery/door/airlock/titanium{name = "Arrivals Shuttle Airlock"},/obj/machinery/door/airlock/titanium{name = "Arrivals Shuttle Airlock"},/turf/open/floor/mineral/titanium/blue,/area/shuttle/arrival)
"Qp" = (/obj/structure/chair/comfy/shuttle{dir = 8},/turf/open/floor/mineral/titanium/blue,/area/shuttle/arrival)
"Rc" = (/obj/machinery/vending/medical,/turf/open/floor/mineral/titanium/blue,/area/shuttle/arrival)
"SQ" = (/obj/structure/table,/obj/effect/spawner/random/entertainment/wallet_storage,/obj/effect/spawner/random/entertainment/wallet_storage,/obj/machinery/light/directional/south,/turf/open/floor/mineral/titanium,/area/shuttle/arrival)
"Tl" = (/obj/structure/table,/obj/item/stack/sheet/glass/fifty,/obj/item/stack/sheet/glass/fifty,/obj/item/stack/sheet/glass/fifty,/obj/item/stack/sheet/glass/fifty,/obj/item/stack/sheet/glass/fifty,/turf/open/floor/mineral/titanium/blue,/area/shuttle/arrival)
"VA" = (/obj/effect/spawner/structure/window/reinforced/shuttle,/obj/structure/fans/tiny/invisible,/turf/open/floor/plating,/area/shuttle/arrival)
"VO" = (/obj/machinery/vending/assist,/turf/open/floor/mineral/titanium/blue,/area/shuttle/arrival)
"Wb" = (/obj/structure/chair/comfy/shuttle,/turf/open/floor/mineral/titanium,/area/shuttle/arrival)
"WH" = (/obj/structure/table,/obj/item/stack/sheet/plastic/fifty,/obj/item/stack/sheet/plastic/fifty,/obj/item/stack/sheet/plastic/fifty,/obj/item/stack/sheet/plastic/fifty,/obj/item/stack/sheet/plastic/fifty,/obj/machinery/light/directional/east,/turf/open/floor/mineral/titanium/blue,/area/shuttle/arrival)
"ZR" = (/obj/machinery/vending/modularpc,/turf/open/floor/mineral/titanium,/area/shuttle/arrival)

(1,1,1) = {"
ljljVAVALTljVAVAljfBfBljVAVAljjCVAqL
fxmewuDVroPLwcZRxfHWHWxflWeiIOPuTlwe
lIhSnKhSnKHWooHWooHWHWooHWooHWQpsseS
ljAVnKhSnKcORcdxaJWbWbDtcKkroiQpWHwe
ljhSnKhSnKHWooHWooHWHWooHWooHWQpjmwe
ljBrEQFvooSQVOBNkuHWHWkuBbiWSQxWsJwe
ljljVAVAjCljVAVAljfBPYljVAVAljLTVAlj
"}
