//MAP CONVERTED BY dmm2tgm.py THIS HEADER COMMENT PREVENTS RECONVERSION, DO NOT REMOVE
"b" = (
/obj/machinery/porta_turret/syndicate/pod,
/turf/closed/wall/mineral/plastitanium,
/area/shuttle/assault_pod/commando)
"c" = (
/obj/structure/chair/comfy/shuttle{
	dir = 4
	},
/turf/open/floor/mineral/plastitanium/red,
/area/shuttle/assault_pod/commando)
"d" = (
/turf/closed/wall/mineral/plastitanium,
/area/shuttle/assault_pod/commando)
"e" = (
/obj/machinery/door/airlock/centcom{
	aiControlDisabled = 1;
	name = "Assault Pod"
	},
/obj/effect/mapping_helpers/airlock/access/all/syndicate/general,
/obj/docking_port/mobile/assault_pod/commando{
	port_direction = 4;
	preferred_direction = 4
	},
/turf/open/floor/plating,
/area/shuttle/assault_pod/commando)
"h" = (
/obj/machinery/computer/shuttle/syndicate/drop_pod/commando,
/turf/closed/wall/mineral/plastitanium,
/area/shuttle/assault_pod/commando)
"p" = (
/turf/open/floor/mineral/plastitanium/red,
/area/shuttle/assault_pod/commando)
"t" = (
/obj/machinery/door/airlock/centcom{
	aiControlDisabled = 1;
	name = "Assault Pod"
	},
/obj/effect/mapping_helpers/airlock/access/all/syndicate/general,
/turf/open/floor/plating,
/area/shuttle/assault_pod/commando)
"D" = (
/obj/machinery/light/directional/north,
/obj/machinery/sleeper/syndie/fullupgrade,
/turf/open/floor/mineral/plastitanium/red,
/area/shuttle/assault_pod/commando)
"H" = (
/obj/structure/chair/comfy/shuttle{
	dir = 8
	},
/turf/open/floor/mineral/plastitanium/red,
/area/shuttle/assault_pod/commando)
"L" = (
/obj/machinery/light/directional/south,
/obj/machinery/sleeper/syndie/fullupgrade{
	dir = 1
	},
/turf/open/floor/mineral/plastitanium/red,
/area/shuttle/assault_pod/commando)
"M" = (
/obj/machinery/sleeper/syndie/fullupgrade{
	dir = 8
	},
/turf/open/floor/mineral/plastitanium/red,
/area/shuttle/assault_pod/commando)
"Q" = (
/obj/machinery/sleeper/syndie/fullupgrade{
	dir = 4
	},
/turf/open/floor/mineral/plastitanium/red,
/area/shuttle/assault_pod/commando)
"R" = (
/obj/machinery/door/airlock/centcom{
	name = "Assault Pod"
	},
/obj/effect/mapping_helpers/airlock/access/all/syndicate/general,
/turf/open/floor/plating,
/area/shuttle/assault_pod/commando)
"V" = (
/turf/template_noop,
/area/template_noop)

(1,1,1) = {"
V
b
d
t
d
b
V
"}
(2,1,1) = {"
b
d
c
p
c
d
b
"}
(3,1,1) = {"
d
c
p
M
p
c
d
"}
(4,1,1) = {"
R
p
L
h
D
p
e
"}
(5,1,1) = {"
d
H
p
Q
p
H
d
"}
(6,1,1) = {"
b
d
H
p
H
d
b
"}
(7,1,1) = {"
V
b
d
t
d
b
V
"}
